1;600,850,550,200;300,600,600,60;500,850,550,200;400,450,50,100;500,350,50,400;600,450,50,250
3;450,600,200,160;300,100,20,700;0,900,1000,20;780,100,20,700;800,1100,800,20;0,1100,500,20;300,100,480,20
4;460,440,180,60;300,500,500,60;0,800,400,60;700,800,400,60;300,300,60,200;740,300,60,200;0,500,120,60;940,500,120,60
5;180,220,120,30;150,250,150,30;270,150,30,100;150,150,30,100
6; 1070, 100, 10, 200; 320, 350, 650, 10; 520, 490, 500, 10; 30, 800, 500, 10; 330, 1200, 300, 10; 200, 150, 700, 10; 330, 1000, 800, 10
8;500,0,150,150,30;400,0,50,200;700,0,50,200;490,300,200,40;400,700,50,200;700,700,50,200;0,1000,200,40;850,1000,200,40
9;500,100,100,100;50,900,200,300;700,200,400,50;400,480,100,200;750,600,200,80;850,400,100,150
11;100,100,100,20;0,200,500,20;700,200,500,20;300,500,500,20;600,800,500,20;0,1000,300,20;200,1250,500,20
12;50,80,400,250;750,120,500,50;0,400,300,170;600,400,200,250;800,900,500,350;100,1500,500,166;750,2000,600,200
14;500,1000,200,50;1000,500,50, 700;100,500,900, 50;250,700, 200,100;650,700, 200,100;200,1200,700, 50;50,500,50,700
16;500,50,100,100;50,900,200,300;400,200,1000,50;200,480,500,200;750,600,200,80;100,200,100,250
19; 280,490,100,30; 200,300,50,200; 200,500,250,50; 400,300,50,200
21;80,40,40,40;40,40,30,500;40,300,300,30;500,1000,500,30;200,600,500,30;200,600,30,600;200,1200,300,30;800,100,300,30
22;400,0,50,800;400,750,700,50;700,400,400,50;110,400,50,400;1200,1000,50,800;700,450,400,300
23;100,100,200,200;700,600,500,20;100,1100,500,200;350,100,50,200;100,400,200,50
24;950,50,80,60;600,200,800,50;200,500,800,50;200,0,30,500